0000000000000000000000000000000000000000000000000000000000000000000000000000000000000000000000000000000000000000000000000000000000000000000000000000000000000000000000000000000000
0000000000000000000000000000000000000400000544444444444000000000000000000000000000000000000000000000000000000000000000000000000000000000000000000000000000000000000000000000000000
0000000000000000000000000000000000003330000333333333333000400000000000000000000000000000000000000000000000000000000000000000000000000000000000000000000000000000000000000000000000
0000000000000000000000000000000004000000000000000000000000300000000000000000000000000000000000000000000000000000000000000000000000000000000000000000000000000000000000000000000000
0000000000000000000000000000000033300000000000000000000030003000000000000000000000000000000000000000000000000000000000000000000000000000000000000000000000000000000000000000000000
0000000000000000000000000000040000000000000000000000004000000000000000000000000000000000000000000000000000000000000000000000000000000000000000000000000000000000000000000000000000
0000000000000000000000000000333000000000000000000000003000000004000000000000000000000000000000000000000000000000000000000000000000000000000000000000000000000000000000000000000000
0000000000000000000000000400000000000000000000000000000000000003000000000000000000000000000000000000000000000000000000000000000000000000000000000000000000000000000000000000000000
0000000000000000000000003330000000000000000000000000300000000000000000000000000000000000000000000000000000000000000000000000000000000000000000000000000000000000000000000000000000
0000000000000000000004000000000000000000000000000040000000000000000000000000000000000000000000000000000000000000000000000000000000000000000000000000000000000000000000000000000000
0000000000000000000033300000000000000000000000000030000000000000005000000000000000000000000000000000000000044000000000000000000000000000000000000000000000000000000000000000000000
0000000000000000040000000000000000000000000000000000000000000000003000000000000000000000000000000000000000333300000000000000000000000004000400040004000400040004000000000000000000
0000000000000000333000000000000000000000000000003000000000000000000000000000000000000000000000000000000003000030000000000300300000000003000300030003000300030003000000000000000000
0000000000004400000000000000000000000000000000000000000000000000000004000000000000000000040000000000000030000003000000000000000000000400040004000400040000000400000000000000000000
0000000000033330000000000000000000000000000000300000000000000000000003000000000000004000333000400000000300000000300000000044000000000300030003000300030003000300004000000000000000
0000000000000000000000000000000000000000044400000000000000000000000000004440000400033300000003330004003000000000030004003333330044400000000000000000000000000000000000000000000000
2222222222000000000000000000000000000000222220000000000000000000000000022222222220000000000000000022200000000000000022200000000222220000000000000000000000000000020222222222222222
1111111111000000000000000000000000000000111110000000000000000000000000011111111110000000000000000011100000000000000011100000000111110000000000000000000000000000010111111111111111
1111111111000000000000000000000000000000111110000000000000000000000000011111111110000000000000000011100000000000000011100000000111110000000000000000000000000000010111111111111111
1111111111000000000000000000000000000000111110000000000000000000000000011111111110000000000000000011100000000000000011100000000111110000000000000000000000000000010111111111111111