00000000000000000000000000000000000000000300030333330333330300000300000000000000000000000000000000000000000000000000000000000000000000000000000000000000000000000000000000000000000
00000000000000000000000000000000000000000300030300000300000330003300000000000000000000000000000000000000000000000000000000000000000000000000000000000000000000000000000000000000000
00000000000000000000000000000000000000000300030300000333330303030300000000000000000000000000000000000000000000000000000000000000000000000000000000000000000000000000000000000000000
00000000000000000000000000000000000000000300030300000000030300300300000000000000000000000000000000000000000000000000000000000000000000000000000000000000000000000000000000000000000
00000000000000000000000000000000000000000333330333330333330300000300000000000000000000000000000000000000000000000000000000000000000000000000000000000000000000000000000000000000000
00000000000000000000000000000000000000000000000000000000000000000000000000000000000000000000000000000000000000000000000000000000000000000000000000000000000000000000000000000000000
00000000000000000000000000000000000000000000000000000000000000000000000000000000000000000000000000000000000000000000000000000000000000000000000000000000000000000000000000000000000
00000000000000000000003003003003003003000000000000000000000000000000000000000000000000000000000000000000000000000000000000000000000000000000000000000000000000000000000000000000000
00000000003003333330000000000000000000000000000000000000000000000000000000000000000000000000000000000000000000000000000000000000000000000000000000000000000000000000000000000000000
00000000000000000000000444444444000000000000000000000000000000000000000000000000000000000000000000000000000000000000000000000000000000000000000000000000000000000000000000000000000
00000000000300000000033333333333333333300000000000040000000000004000000000400000000000000000000000400000004000004000000000000000000000000000004400044000000000000000000000000000000
00000000000000000000000000000000000000000000003003333303003000003000000000300000344303000003000000300000333330333330304030304030304030304030033330333303000003000000000000000000000
00000000000003040000000444440444444445000000300000030003443000030300000003030030343003340433000003030030003000003000334030334030334030334030030030300303344433000000000000000000000
00000000000000333000033333333333333333300000000000030003333000333330000033333000330003030303000033333000003000003000303030303030303030303030033330333303034303000000000000000000000
00000000000300000003000000000000000000000030000000030003003003000003000300000300303003003003000300000300003000003000300330300330300330300330030000300003003003000000000000000000000
00000000000304444403044444444444444445000300000000030303003030000000303000000030300303000003003000000030333000333000300030300030300030300030030000300003000003000000000000000000000
22222222222222222222222222222222222222200222222222222202222222222222222222222220222202222222222222222220222220222220222220222220222220222220022220222202222222222222222222222222222
11111111111111111111111111111111111111100111111111111101111111111111111111111110111101111111111111111110111110111110111110111110111110111110011110111101111111111111111111111111111
11111111111111111111111111111111111111100111111111111101111111111111111111111110111101111111111111111110111110111110111110111110111110111110011110111101111111111111111111111111111
11111111111111111111111111111111111111100111111111111101111111111111111111111110111101111111111111111110111110111110111110111110111110111110011110111101111111111111111111111111111